#####
#PXO#
#  O#
# X #
#####
